#########.#######
#...............#
#.###E###.#####.#
#.#C..#W..#..E..#
#.#.#.#.###.###.#
#.#.#.#C..#.#...#
#.#.#####.#.#.###
#.#.....#.#.#C#W#
#.###.#####.###.#
#..W#....##.....#
#.#.###.###.#####
#.#..E....#.#...#
#.#######.#.#.#.#
#..C....#.#..E#.#
#.#.#####.#####.#
#.#..W...E......#
#########A#######